////////////////////////////////////////////////////////
////////////////////////////////////////////////////////
////////////////////////////////////////////////////////
+++++++++++++++++++++++++++++++++++++++++++++++++++++++++
+                                                       +
+ . . . . . . . . . . . . . . . . . . . . . . . . . . . +
+                                                       +
+ . +++++++++ . ++++++++++++ . ++++++++++ . +++++++++ . +
+                                                       +
+ . . . . . . . . . . . . . . . . . . . . . . . . . . . +
+                                                       +
+ . +++++++++ . ++++++++++++ . ++++++++++ . +++++++++ . +
+                                                       +
+ . . . . . . . . . . . . . . . . . . . . . . . . . . . +
+                                                       +
+ . +++++++++ . ++++++++++++ . ++++++++++ . +++++++++ . +
+                                                       +
+ O . . . . . . . . . . . . . . . . . . . . . . . . . O +
+                                                       +
+++++++++++++ . ++++++++++++ . ++++++++++ . +++++++++++++
            +                               +       
            + . . . . . . . . . . . . . . . +              
            +                               +      
+++++++++++++ . +++++++++++    ++++++++++ . +++++++++++++      
                    +               +     
. . . . . . . . . . +               + . . . . . . . . . .
                    +               +
+++++++++++++ . + . +++++++++++++++++ . + . +++++++++++++
            +   +                       +   +
            + . + . . . . . . . . . . . + . +
            +   +                       +   +
+++++++++++++ . ++++++++++++ . ++++++++++ . +++++++++++++
+                                                       +
+ O . . . . . . . . . . . . . . . . . . . . . . . . . O +
+                                                       +
+ . +++++++++ . ++++++++++++ . ++++++++++ . +++++++++ . +
+                                                       +
+ . . . . . . . . . . . . . . . . . . . . . . . . . . . +
+                                                       +
+ . +++++++++ . ++++++++++++ . ++++++++++ . +++++++++ . +
+                                                       +   
+ . . . . . . . . . . . . . . . . . . . . . . . . . . . +   
+                                                       +   
+ . +++++++++ . ++++++++++++ . ++++++++++ . +++++++++ . +
+                                                       +
+ . . . . . . . . . . . . . . . . . . . . . . . . . . . +
+                                                       +
+++++++++++++++++++++++++++++++++++++++++++++++++++++++++ 
