////////////////////////////////////////////////////////
////////////////////////////////////////////////////////
////////////////////////////////////////////////////////
+++++++++++++++++++++++++++++++++++++++++++++++++++++++++
+                           +                           +
+ O . . . . . . . . . . . . + . . . . . . . . . . . . O +
+                           +                           +
+ . +++++++++ . +++++++++ . + . +++++++++ . +++++++++ . +
+   +       +   +       +   +   +       +   +       +   +
+ . +       + . +       + . + . +       + . +       + . +
+   +       +   +       +   +   +       +   +       +   +
+ . +++++++++ . +++++++++ . + . +++++++++ . +++++++++ . +
+                                                       +
+ . . . . . . . . . . . . . . . . . . . . . . . . . . . +
+                                                       +
+ . +++++++++ . + . +++++++++++++++++ . + . +++++++++ . +
+               +           +           +               +
+ . . . . . . . + . . . . . + . . . . . + . . . . . . . +
+               +           +           +               +
+++++++++++++ . +++++++++   +   +++++++++ . +++++++++++++
            +   +                       +   +       
            + . +                       + . +      
            +   +                       +   +      
+++++++++++++ . +   ++++++     ++++++   + . +++++++++++++      
                    +               +     
              .     +               +     .
                    +               +
+++++++++++++ . +   +++++++++++++++++   + . +++++++++++++
            +   +                       +   +
            + . +                       + . +
            +   +                       +   +
+++++++++++++ . +   +++++++++++++++++   + . +++++++++++++
+                           +                           +
+ O . . . . . . . . . . . . + . . . . . . . . . . . . O +
+                           +                           +
+ . +++++++++ . +++++++++ . + . +++++++++ . +++++++++ . +
+           +                               +           +
+ . . . . . + . . . . . . . . . . . . . . . + . . . . . +
+           +                               +           +
+++++++++ . + . + . +++++++++++++++++ . + . + . +++++++++
+               +           +           +               +   
+ . . . . . . . + . . . . . + . . . . . + . . . . . . . +   
+               +           +           +               +   
+ . +++++++++++++++++++++ . + . +++++++++++++++++++++ . +
+                                                       +
+ . . . . . . . . . . . . . . . . . . . . . . . . . . . +
+                                                       +
+++++++++++++++++++++++++++++++++++++++++++++++++++++++++ 
