////////////////////////////////////////////////////////
////////////////////////////////////////////////////////
////////////////////////////////////////////////////////
+++++++++++++++++++++++++++++++++++++++++++++++++++++++++
+                           +                           +
+ . . . . . . . . . . . . . + . . . . . . . . . . . . . +
+                           +                           +
+ . + . + . + . + . + . + . + . + . + . + . + . + . + . +
+   +   +   +   +   +   +   +   +   +   +   +   +   +   +
+ . + . + . + . + . + . + . + . + . + . + . + . + . + . +
+   +   +   +   +   +   +   +   +   +   +   +   +   +   +
+ . + . + . + . + . + . + . + . + . + . + . + . + . + . +
+                                                       +
+ . . . . . . . . . . . . . . . . . . . . . . . . . . . +
+                                                       +
+ . + . + . + . + . + . + . + . + . + . + . + . + . + . +
+   +   +   +   +   +   +   +   +   +   +   +   +   +   +
+ . + . + . + . + . + O + . + . + O + . + . + . + . + . +
+   +   +   +   +   +   +   +   +   +   +   +   +   +   +
+++++++++++++ . +++++++++   +   +++++++++ . +++++++++++++
            +   +                       +   +       
            + . +                       + . +      
            +   +                       +   +      
+++++++++++++ . +   +++++++   +++++++   + . +++++++++++++      
                    +               +     
              .     +               +     .
                    +               +
+++++++++++++ . +   +++++++++++++++++   + . +++++++++++++
            +   +                       +   +
            + . +                       + . +
            +   +                       +   +
+++++++++++++ . +   +++++++++++++++++   + . +++++++++++++
+   +   +   +   +   +   +   +   +   +   +   +   +   +   +
+ . + . + . + . + . + . + O + O + . + . + . + . + . + . +
+   +   +   +   +   +   +   +   +   +   +   +   +   +   +
+ . + . + . + . + . + . + . + . + . + . + . + . + . + . +
+   +   +   +   +   +   +   +   +   +   +   +   +   +   +
+ . + . + . + . + . + . + . + . + . + . + . + . + . + . +
+                                                       +
+ . . . . . . . . . . . . . . . . . . . . . . . . . . . +
+                                                       +   
+ . + . + . + . + . + . + . + . + . + . + . + . + . + . +   
+   +   +   +   +   +   +   +   +   +   +   +   +   +   +   
+ . + . + . + . + . + . + . + . + . + . + . + . + . + . +
+                                                       +
+ . . . . . . . . . . . . . . . . . . . . . . . . . . . +
+                                                       +
+++++++++++++++++++++++++++++++++++++++++++++++++++++++++ 
