////////////////////////////////////////////////////////
////////////////////////////////////////////////////////
////////////////////////////////////////////////////////
+++++++++++++++++++++++++++++++++++++++++++++++++++++++++
+                           +                           +
+ O . . . . . . . . . . . . + . . . . . . . . . . . . O +
+                           +                           +
+ . +++++++++ . +   +   + . + . +   +   + . +++++++++ . +
+                           +                           +
+ . . . . . . . . . . . . . + . . . . . . . . . . . . . +
+                           +                           +
+ . +++++++++ . +   +   + . + . +   +   + . +++++++++ . +
+       +                                       +       +
+ . . . + . . . . . . . . . .  . . . . . . . . . + . . . +
+       +                                       +       +
+ . +++++++++ . + . +++++++++++++++++ . + . +++++++++ . +
+               +           +           +               +
+ . . . . . . . + . . . . . + . . . . . + . . . . . . . +
+               +           +           +               +
+++++++++++++ . +++++++++   +   +++++++++ . +++++++++++++
            +   +                       +   +       
            + . +                       + . +      
            +   +                       +   +      
+++++++++++++ . +   ++++++     ++++++   + . +++++++++++++      
                    +               +     
              .     +               +     .
                    +               +
+++++++++++++ . +   +++++++++++++++++   + . +++++++++++++
            +   +                       +   +
            + . +   +               +   + . +
            +   +   +               +   +   +
+++++++++++++ . +   +++++ . + . +++++   + . +++++++++++++
+                           +                           +
+ O . . . . . . . . . . . . + . . . . . . . . . . . . O +
+                           +                           +
+ . +++++ . + . +   +   + . + . +   +   + . + . +++++ . +
+           +                               +           +
+ . . . .   +   . . . . . . . . . . . . .   +   . . . . +
+           +                               +           +
+++++++++ . + . + . +++++++++++++++++ . +   + . +++++++++
+               +           +           +               +   
+ . . . . . . . + . . . . . + . . . . . + . . . . . . . +   
+               +           +           +               +   
+ . +++++++++   +   ++++++  +  ++++++   +   +++++++++ . +
+               +                       +               +
+ . . . . . .   + . . . . . . . . . . . +   . . . . . . +
+               +                       +               +
+++++++++++++++++++++++++++++++++++++++++++++++++++++++++
